{
 "bad": false,
 "new_version": "1.15.7",
 "new_version_attempts": {
  "1.10.0": 1,
  "1.11.0": 1,
  "1.12.0": 1,
  "1.13.1": 1,
  "1.13.5": 1,
  "1.14.0": 1,
  "1.15.1": 1,
  "1.15.7": 1
 },
 "new_version_errors": {}
}